11111111
12000001
10001111
10000031
11111111