111111111111111
120000000000001
100011110000001
100000000000001
100100010000101
111111100000001
100000000000031
111111111111111